1111111111111111
1000001000100101
1010100010001001
1001011101010011
1010000001001001
1011101111100101
1000001000110101
1111101010000101
1000101011010101
1010101001110101
1010101100010101
1010101001110101
1010001010000101
1010111001111001
1000000100000011
1111111111111111